1111111111111
1P00000000011
1000000000001
100000E000001
1000000000001
10000000C0001
10000000C0001
10000000C0001
1000000000001
1000000000001
1000000000001
1000000000001
1000000000001
1111111111111
