1111111111111
1PC0000C00011
100C000000001
100000E000001
1000C0000C001
1CC00000C0001
1CC00000C0001
1CC00000C0001
1CC00C00C0001
1CC00000C0001
1CC000C0C0001
1CC00000C0001
1CC00000C0001
1111111111111